000100000100000100000100000100000100000100000100000100000100000100000100000100000100000100000100000100000100000100000100,
010110010110010110010110010110010110010110010110010110010110010110010110010110010110010110010110010110010110010110010110,
000100000100000100000100000100000100000100000100000100000100000100000100000100000100000100000100000100000100000100000100,
0101100101100103A00101100101100101100101100101100101100101100101100102A00101100101100101100101100101100102A0010110010110,
0001000000A00001000001000001000001000003B00001000001000001000001000001000001000001000002A0000100000100000100000100000100,
010110010110010110010110010110010110010110010110010110010110010110010110010110010110010110010110010110010110010110010110,
0001000002A0000100000100000100000100000100000100000100000100000100000100000100000100000100000100000100000100000100000100,
0101100101100101100101100101100101100101100101100101100101100101B0010110010110010110010110010110010110010110010110010110,
0001000001000001000001000001000001000001000001000001000002<13<11000001000001000001000001000001000001000002A0000100000100,
0103A00101100101100101100101100101100101100103A00101100104=13=1110010110010110010110010110010110010110010110010110010110,
000100000100000100000100000100000100000100000100000100000100000100000100000100000100000100000100000100000100000100000100,
0101100101100101100101104>15>16>17>1010110010110010110010110010110010110010110010110010110010110010110010110010110010110,
0001000001000001000001004?15?16?17?10001000001000001000001000001000001000001004>15>16>17>1000100000100000100000100000100,
0101100101100101100101104@15@16@17@10101100101100103B00101100101100101100101104?15?16?17?1010110010110010110010110010110,
0001000001000001000001000001000001000001000001000001000001000001000001000001004@15@16@17@1000100000100000100000100000100,
010110010110010110010110010110010110010110010110010110010110010110010110010110010110010110010110010110010110010110010110,
000100000100000100000100000100000100000100000100000100000100000100000100000100000100000100000100000100000100000100000100,
0101100101100101100101100101100101100101100101100102A00101100101100101100101100101100101100101100101100101100103A0010110,
0001000001000001000003A0000100000100000100000100000100000100000100000100000100000100000100000100000100000100000100000100,
0101100101100101100101100101100101100101100101100101100101100101100102A0010110010110010110010110010110010110010110010110,
0001000001000001000001000001000001000001000000A0000100000100000100000100000100000100000100000100000100000100000100000100,
0101100101100101100100C0010110010110010110010110010110010110010110010110010110010110010110010110010110010110010110010110,
0001000001000002<13<11000001000001000001000001000001000001000001000001000003B0000100000100000100000100000100000100000100,
0101100101100102=15=1110010110010110010110010110010110010110010110010110010110010110010110010110010110010110010110010110,
0001000001000000A00001000001000001000001000001000001000001000001000001000001000000A00002<13<1100000100000100000100000100,
0101100101100101100101100101100101100101100101100101100101100101100101100101100101100102=13=1110010110010110010110010110,
0001000001000001000001000002A00001000003B00001000001000002<13<11000001000001000001000001000000A0000100000100000100000100,
0101100101100101100101100101100101100101100101100101100102=15=1110010110010110010110010110010110010110010110010110010110,
0001000001000001000001000001000001000001000001000001000001000001000001000001000000A0000100000100000100000100000100000100,
010110010110010110010110010110010110010110010110010110010110010110010110010110010110010110010110010110010110010110010110,
,
,
,
,
,
,
,
,
,
,
,
,
,
,
,
,
,
,
,
,
,
