000100000100000100000100000100000100000100000100000100000100000100000100000100000100000100000100000100000100000100000100000100000100000100000100000100000100000100000100000100000100000100000100000100000100000100000100000100000100000100000100,
010110010110010110010110010110010110010110010110010110010110010110010110010110010110010110010110010110010110010110010110010110010110010110010110010110010110010110010110010110010110010110010110010110010110010110010110010110010110010110010110,
000100000100000100000100000100000100000100000100000100000100000100000100000100000100000100000100000100000100000100000100000100000100000100000100000100000100000100000100000100000100000100000100000100000100000100000100000100000100000100000100,
0101100101100103A00101100101100101100101100101100101100101100101100102A00101100101100101100101100101100102A00101100101100101100101100103A00101100101100101100101100101100101100101100101100102A00101100101100101100101100101100102A0010110010110,
0001000000A00001000001000001000001000003B00001000001000001000001000001000001000001000002A00001000001000001000001000001000001000000A00001000001000001000001000003B00001000001000001000001000001000001000001000002A0000100000100000100000100000100,
010110010110010110010110010110010110010110010110010110010110010110010110010110010110010110010110010110010110010110010110010110010110010110010110010110010110010110010110010110010110010110010110010110010110010110010110010110010110010110010110,
0001000002A00001000001000001000001000001000001000001000001000001000001000001000001000001000001000001000001000001000001000001000002A0000100000100000100000100000100000100000100000100000100000100000100000100000100000100000100000100000100000100,
0101100101100101100101100101100101100101100101100101100101100101B00101100101100101100101100101100101100101100101100101100101100101100101100101100101100101100101100101100101100101100101B0010110010110010110010110010110010110010110010110010110,
0001000001000001000001000001000001000001000001000001000002<13<11000001000001000001000001000001000001000002A00001000001000001000001000001000001000001000001000001000001000001000002<13<11000001000001000001000001000001000001000002A0000100000100,
0103A00101100101100101100101100101100101100103A00101100104=13=11100101100101100101100101100101100101100101100101100101100103A00101100101100101100101100101100101100103A00101100104=13=1110010110010110010110010110010110010110010110010110010110,
000100000100000100000100000100000100000100000100000100000100000100000100000100000100000100000100000100000100000100000100000100000100000100000100000100000100000100000100000100000100000100000100000100000100000100000100000100000100000100000100,
0101100101100101100101104>35>36>37>30101100101100101100101100101100101100101100101100101100101100101100101100101100101100101100101100101100101104>35>36>37>3010110010110010110010110010110010110010110010110010110010110010110010110010110010110,
0001000001000001000001004?35?36?37?30001000001000001000001000001000001000001004>35>36>37>30001000001000001000001000001000001000001000001000001004?35?36?37?30001000001000001000001000001000001000001004>35>36>37>3000100000100000100000100000100,
0101100101100101100101104@35@36@37@30101100101100103B00101100101100101100101104?35?36?37?30101100101100101100101100101100101100101100101100101104@35@36@37@30101100101100103B00101100101100101100101104?35?36?37?3010110010110010110010110010110,
0001000001000001000001000001000001000001000001000001000001000001000001000001004@35@36@37@30001000001000001000001000001000001000001000001000001000001000001000001000001000001000001000001000001000001004@35@36@37@3000100000100000100000100000100,
010110010110010110010110010110010110010110010110010110010110010110010110010110010110010110010110010110010110010110010110010110010110010110010110010110010110010110010110010110010110010110010110010110010110010110010110010110010110010110010110,
000100000100000100000100000100000100000100000100000100000100000100000100000100000100000100000100000100000100000100000100000100000100000100000100000100000100000100000100000100000100000100000100000100000100000100000100000100000100000100000100,
0101100101100101100101100101100101100101100101100102A00101100101100101100101100101100101100101100101100101100103A00101100101100101100101100101100101100101100101100101100102A00101100101100101100101100101100101100101100101100101100103A0010110,
0001000001000001000003A00001000001000001000001000001000001000001000001000001000001000001000001000001000001000001000001000001000001000001000003A0000100000100000100000100000100000100000100000100000100000100000100000100000100000100000100000100,
0101100101100101100101100101100101100101100101100101100101100101100102A00101100101100101100101100101100101100101100101100101100101100101100101100101100101100101100101100101100101100101100102A0010110010110010110010110010110010110010110010110,
0001000001000001000001000001000001000001000000A00001000001000001000001000001000001000001000001000001000001000001000001000001000001000001000001000001000001000001000000A0000100000100000100000100000100000100000100000100000100000100000100000100,
0101100101100101100100C00101100101100101100101100101100101100101100101100101100101100101100101100101100101100101100101100101100101100101100100C0010110010110010110010110010110010110010110010110010110010110010110010110010110010110010110010110,
0001000001000002<13<11000001000001000001000001000001000001000001000001000003B00001000001000001000001000001000001000001000001000001000002<13<11000001000001000001000001000001000001000001000001000003B0000100000100000100000100000100000100000100,
0101100101100102=15=11100101100101100101100101100101100101100101100101100101100101100101100101100101100101100101100101100101100101100102=15=1110010110010110010110010110010110010110010110010110010110010110010110010110010110010110010110010110,
0001000001000000A00001000001000001000001000001000001000001000001000001000001000000A00002<13<11000001000001000001000001000001000001000000A00001000001000001000001000001000001000001000001000001000001000000A00002<13<1100000100000100000100000100,
0101100101100101100101100101100101100101100101100101100101100101100101100101100101100102=13=11100101100101100101100101100101100101100101100101100101100101100101100101100101100101100101100101100101100101100102=13=1110010110010110010110010110,
0001000001000001000001000002A00001000003B00001000001000002<13<11000001000001000001000001000000A00001000001000001000001000001000001000001000001000002A00001000003B00001000001000002<13<11000001000001000001000001000000A0000100000100000100000100,
0101100101100101100101100101100101100101100101100101100102=15=11100101100101100101100101100101100101100101100101100101100101100101100101100101100101100101100101100101100101100102=15=1110010110010110010110010110010110010110010110010110010110,
0001000001000001000001000001000001000001000001000001000001000001000001000001000000A00001000001000001000001000001000001000001000001000001000001000001000001000001000001000001000001000001000001000001000000A0000100000100000100000100000100000100,
010110010110010110010110010110010110010110010110010110010110010110010110010110010110010110010110010110010110010110010110010110010110010110010110010110010110010110010110010110010110010110010110010110010110010110010110010110010110010110010110,
000100000100000100000100000100000100000100000100000100000100000100000100000100000100000100000100000100000100000100000100000100000100000100000100000100000100000100000100000100000100000100000100000100000100000100000100000100000100000100000100,
010110010110010110010110010110010110010110010110010110010110010110010110010110010110010110010110010110010110010110010110010110010110010110010110010110010110010110010110010110010110010110010110010110010110010110010110010110010110010110010110,
000100000100000100000100000100000100000100000100000100000100000100000100000100000100000100000100000100000100000100000100000100000100000100000100000100000100000100000100000100000100000100000100000100000100000100000100000100000100000100000100,
0101100101100103A00101100101100101100101100101100101100101100101100102A00101100101100101100101100101100102A00101100101100101100101100103A00101100101100101100101100101100101100101100101100102A00101100101100101100101100101100102A0010110010110,
0001000000A00001000001000001000001000003B00001000001000001000001000001000001000001000002A00001000001000001000001000001000001000000A00001000001000001000001000003B00001000001000001000001000001000001000001000002A0000100000100000100000100000100,
010110010110010110010110010110010110010110010110010110010110010110010110010110010110010110010110010110010110010110010110010110010110010110010110010110010110010110010110010110010110010110010110010110010110010110010110010110010110010110010110,
0001000002A00001000001000001000001000001000001000001000001000001000001000001000001000001000001000001000001000001000001000001000002A0000100000100000100000100000100000100000100000100000100000100000100000100000100000100000100000100000100000100,
0101100101100101100101100101100101100101100101100101100101100101B00101100101100101100101100101100101100101100101100101100101100101100101100101100101100101100101100101100101100101100101B0010110010110010110010110010110010110010110010110010110,
0001000001000001000001000001000001000001000001000001000002<13<11000001000001000001000001000001000001000002A00001000001000001000001000001000001000001000001000001000001000001000002<13<11000001000001000001000001000001000001000002A0000100000100,
0103A00101100101100101100101100101100101100103A00101100104=13=11100101100101100101100101100101100101100101100101100101100103A00101100101100101100101100101100101100103A00101100104=13=1110010110010110010110010110010110010110010110010110010110,
000100000100000100000100000100000100000100000100000100000100000100000100000100000100000100000100000100000100000100000100000100000100000100000100000100000100000100000100000100000100000100000100000100000100000100000100000100000100000100000100,
0101100101100101100101104>35>36>37>30101100101100101100101100101100101100101100101100101100101100101100101100101100101100101100101100101100101104>35>36>37>3010110010110010110010110010110010110010110010110010110010110010110010110010110010110,
0001000001000001000001004?35?36?37?30001000001000001000001000001000001000001004>35>36>37>30001000001000001000001000001000001000001000001000001004?35?36?37?30001000001000001000001000001000001000001004>35>36>37>3000100000100000100000100000100,
0101100101100101100101104@35@36@37@30101100101100103B00101100101100101100101104?35?36?37?30101100101100101100101100101100101100101100101100101104@35@36@37@30101100101100103B00101100101100101100101104?35?36?37?3010110010110010110010110010110,
0001000001000001000001000001000001000001000001000001000001000001000001000001004@35@36@37@30001000001000001000001000001000001000001000001000001000001000001000001000001000001000001000001000001000001004@35@36@37@3000100000100000100000100000100,
010110010110010110010110010110010110010110010110010110010110010110010110010110010110010110010110010110010110010110010110010110010110010110010110010110010110010110010110010110010110010110010110010110010110010110010110010110010110010110010110,
000100000100000100000100000100000100000100000100000100000100000100000100000100000100000100000100000100000100000100000100000100000100000100000100000100000100000100000100000100000100000100000100000100000100000100000100000100000100000100000100,
0101100101100101100101100101100101100101100101100102A00101100101100101100101100101100101100101100101100101100103A00101100101100101100101100101100101100101100101100101100102A00101100101100101100101100101100101100101100101100101100103A0010110,
0001000001000001000003A00001000001000001000001000001000001000001000001000001000001000001000001000001000001000001000001000001000001000001000003A0000100000100000100000100000100000100000100000100000100000100000100000100000100000100000100000100,
0101100101100101100101100101100101100101100101100101100101100101100102A00101100101100101100101100101100101100101100101100101100101100101100101100101100101100101100101100101100101100101100102A0010110010110010110010110010110010110010110010110,
0001000001000001000001000001000001000001000000A00001000001000001000001000001000001000001000001000001000001000001000001000001000001000001000001000001000001000001000000A0000100000100000100000100000100000100000100000100000100000100000100000100,
0101100101100101100100C00101100101100101100101100101100101100101100101100101100101100101100101100101100101100101100101100101100101100101100100C0010110010110010110010110010110010110010110010110010110010110010110010110010110010110010110010110,
0001000001000002<13<11000001000001000001000001000001000001000001000001000003B00001000001000001000001000001000001000001000001000001000002<13<11000001000001000001000001000001000001000001000001000003B0000100000100000100000100000100000100000100,
0101100101100102=15=11100101100101100101100101100101100101100101100101100101100101100101100101100101100101100101100101100101100101100102=15=1110010110010110010110010110010110010110010110010110010110010110010110010110010110010110010110010110,
0001000001000000A00001000001000001000001000001000001000001000001000001000001000000A00002<13<11000001000001000001000001000001000001000000A00001000001000001000001000001000001000001000001000001000001000000A00002<13<1100000100000100000100000100,
0101100101100101100101100101100101100101100101100101100101100101100101100101100101100102=13=11100101100101100101100101100101100101100101100101100101100101100101100101100101100101100101100101100101100101100102=13=1110010110010110010110010110,
0001000001000001000001000002A00001000003B00001000001000002<13<11000001000001000001000001000000A00001000001000001000001000001000001000001000001000002A00001000003B00001000001000002<13<11000001000001000001000001000000A0000100000100000100000100,
0101100101100101100101100101100101100101100101100101100102=15=11100101100101100101100101100101100101100101100101100101100101100101100101100101100101100101100101100101100101100102=15=1110010110010110010110010110010110010110010110010110010110,
0001000001000001000001000001000001000001000001000001000001000001000001000001000000A00001000001000001000001000001000001000001000001000001000001000001000001000001000001000001000001000001000001000001000000A0000100000100000100000100000100000100,
*link 58;0;60;60;big2.map;2
*link 0;0;2;60;big2.map;38
*link 0;0;60;2;big2.map;;38
*link 0;50;60;52;big2.map;;2